################
###O####...#####
###.##...#.#####
###.##.###.#####
###....###...X##
################